# lvlwidth 33
# lvlheight 23
# bgcolor 0 0 0
# edgecolor 85 0 170
# fillcolor 128 0 255
# pelletcolor 255 255 255
# fruittype 2

# startleveldata
0 113 21 113 0 0 0 0 0 0 0 0 0 0 0 113 21 113 0 0 0 0 0 0 0 0 0 0 0 113 21 113 0 
0 101 0 105 100 100 100 100 100 100 133 100 100 100 100 106 0 105 100 100 100 100 133 100 100 100 100 100 100 106 0 101 0 
0 101 0 0 0 0 0 0 0 10 101 0 0 0 0 0 0 0 0 0 0 0 101 0 0 0 0 0 0 0 0 101 0 
111 106 0 111 112 0 113 0 113 0 110 0 111 100 100 100 133 100 100 100 112 0 110 0 113 0 113 0 111 112 0 105 112 
20 0 0 0 0 0 101 0 101 0 0 0 0 0 0 0 101 0 0 0 0 0 0 0 101 0 101 0 0 0 0 0 20 
111 108 0 111 100 100 106 0 105 100 112 0 111 100 108 0 101 0 107 100 112 0 111 100 106 0 105 100 100 112 0 107 112 
0 101 0 0 0 0 0 0 0 0 0 0 0 0 110 0 110 0 110 0 0 0 0 0 0 0 0 0 0 0 0 101 0 
0 131 100 100 112 0 111 100 108 0 107 100 112 0 0 0 0 0 0 0 111 100 108 0 107 100 112 0 111 100 100 132 0 
0 101 0 0 0 0 0 0 110 0 110 0 0 0 107 112 1 111 108 0 0 0 110 0 110 0 0 0 0 0 0 101 0 
0 101 0 120 0 111 112 0 0 0 0 0 113 0 101 11 12 13 101 0 113 0 0 0 0 0 111 112 0 120 0 101 0 
0 101 0 0 0 0 0 0 120 0 111 100 132 0 105 100 100 100 106 0 131 100 112 0 120 0 0 0 0 0 0 101 0 
0 101 0 111 100 100 112 0 0 0 0 0 110 0 0 0 0 0 0 0 110 0 0 0 0 0 111 100 100 112 0 101 0 
0 101 0 0 0 0 0 0 113 0 113 0 0 0 113 0 113 0 113 0 0 0 113 0 113 0 0 0 0 0 0 101 0 
0 101 0 111 112 0 120 0 110 0 110 0 111 100 106 0 110 0 105 100 112 0 110 0 110 0 120 0 111 112 0 101 0 
0 101 0 0 0 0 0 0 0 0 0 0 0 0 0 0 0 0 0 0 0 0 0 0 0 0 0 0 0 0 0 101 0 
0 105 100 108 0 107 112 0 111 100 100 100 112 0 111 100 133 100 112 0 111 100 100 100 112 0 111 108 0 107 100 106 0 
0 0 0 101 0 101 0 0 0 0 0 0 0 0 0 0 101 0 0 0 0 0 0 0 0 0 0 101 0 101 0 0 0 
111 100 100 106 0 101 0 113 0 111 133 100 100 100 108 0 110 0 107 100 100 100 133 112 0 113 0 101 0 105 100 100 112 
20 0 4 0 0 101 0 101 0 0 101 0 0 0 101 0 0 0 101 0 0 0 101 0 0 101 0 101 0 0 0 0 20 
111 108 0 120 0 110 0 105 112 0 110 0 113 0 110 0 120 0 110 0 113 0 110 0 111 106 0 110 0 120 0 107 112 
0 101 0 0 0 0 0 0 0 0 0 0 101 0 0 0 0 0 0 0 101 0 0 0 0 0 0 0 0 0 0 101 0 
0 101 0 107 100 100 100 100 100 100 100 100 130 100 100 108 0 107 100 100 130 100 100 100 100 100 100 100 100 108 0 101 0 
0 110 21 110 0 0 0 0 0 0 0 0 0 0 0 110 21 110 0 0 0 0 0 0 0 0 0 0 0 110 21 110 0 
# endleveldata

# sprites
